#########
#M      #
####### #
#   #K# #
#g#   #g#
#########